          ┏━━━┓  ┏━━━┓  ┏━━━┓                 
          ┃   ┃  ┃   ┃  ┃   ┃                 
        ┏━┻┄┄┄┻━━┻┄┄┄┻━━┻┄┄┄┻━━━┳━━━━━━━━━━━━┓
        ┃                       ┃            ┃
        ┃                       │            ┃
        ┃                       ┃            ┃
        ┃                       ┃            ┃
        ┃                       ┃            ┃
        ┃                       ┣━━━━━━━━━━━━┛
┏━━━━━━━┻━━━━━━━━━━─━━━━━━━━━━━━┻━━━━━━━━━━━━┓
┃                                            ┃
┃                                            ┃
┃                                            ┃
┗━━━━━━━━━━━━━━━━━━━━━━━━━━━━━━━━━━━━━━━━━━━━┛
